1111
1P01
1101
1C01
1101
1E01
1111
