11111111111111111111111111111
1I01C0000000000000000000C10C1
10010000000000000000000001001
10000000000000000000000001001
10000000011111111111000001001
10010000010000000001000001001
10010000010000E00001000001001
10010000010000000001000001001
1001K0000111111101110000L1001
10010000010000010000000001001
10010000010P00001000000001001
10010000010000000100000001001
10010000010000000010000001001
10010000010000000001000000001
10010000000000000000000000001
10010000000000000000000001001
1C01C0000000000000000000C10J1
11111111111111111111111111111
